##############################
# #   #     #  #    # #      #
#   #  # # # #  # # #   # ####
###  ##   #  # # #    ## #   #
#  #    ## #   #  # ##     # #
# # ###     # # # # # # ###  #
#       # #                # #
### ## #  # # ## ### ### #  ##
#  #    ##  # #    #    # #  #
# #  ## # # #### ##  # ##  # #
# # #   # #   #  # ##    # ###
#  ### #    #  #     # ##    #
# # ###  # # ##  # ## ## # # #
#    # ##      # #          ##
## #   ## ### #  # # # ## #  #
###  #       # #  #  #   #  ##
##  # # # ##    # # # # # ## #
#  #     # ## # #  ##        #
##  ## #     ##  #   ## ## # #
#  ### # # #   ##  #  # # #  #
##  #  # #  ##  ## # #     # #
# ## # #  ### #   #   # # #  #
#       #     # #  ## # #  # #
# # # ## # # #   ##  #   # # #
# ##   #    ### ## # # #  ## #
#   # #  ##  #       # # #   #
# #  ###  # #### # # # # ## ##
# # # # #  # #   ## #  #   # #
# #      #    ##     ##  #   #
##############################
