###############
#      #     ##
# ####  ### # #
# #  # #      #
## #     ### ##
#    ###    ###
## ##    # # ##
# ##  # #     #
#    #   # # ##
###############
