####################################################################################################
# #  #     # #    # ###   #  #   #    #  ##      # # #      # ## # # # #  #    #     #  #  #  #  # #
# # # ## #    # ##   #  #  #  ## # # #  #  #### #     ### #        # #  #   # # # ### #   # #  #   #
#      ##  # #  #  #  ## # ##  #    # # ## #     # # #   # # # # #     ### # #    #   # # #   #  # #
## # #  # ##   #  #  ##       # # #        ## # # #   # ##  # # # # ### #     # # ## #   ### # ##  #
#   # #  #  ##  ##  #  ## ### #  ##### # #   ##    # ## # # #            # # #  #  #  # # #      # #
## #   #  #   #    #  #  ##     # #   # # ## # # #      # # # ### # # # ## ## ## #  # #    # # # # #
### # # #   ##  ## # # #    # # #  # ##        ## #####   # # #  # #   #    #  # ## # # # #   # #  #
##        #  # #        ####   # #      # ## #         ##    # #   # #  ## #  #   #   # ## # #  # ##
# # # ## #  # # #### # ##   # #   ## # #####  ## # # #  # ##    ##  #  ###  #  # #  # #  #     #   #
# # ##  # # # # #     ##  #    ##  ## ### # ##  # ## # # #### #   #  #  #  #  #    ###  # # # ### ##
#  # # #        # ## #  ## ## #  #  #  #      #   #   #  ###### #### # #  #  # # #  # #      ####  #
# #      # # ## #  #   ##  #   # # #  ### ## # ## ###   # ###   # #     #   #  # # #  # ## ## ##  ##
# # ### #   #    ## # ##  # # #  #  #  # # # #        # #  # ## #  #### # ##  # ## # #   ##     #  #
#  ##  # # # # #        #     ##  #   #        # # ## #  #    #  #           #  #      #   # ###  ##
# #  #     #  #  #### #   # #   #  ##  # ## # ## #   #  # # ## # #### ## # #  # # # # ## ### #  #  #
#  #  # # #  #  #      # ### # # #  # # #  # #    ## ##              #   #  ##     ###  ##     ### #
##  # ## #  # # # # ### # ## #     #    ## #   # #  # # # # ## # # #  # #  #  # # # ## #  # # # #  #
# # #    ## #  # # ##         ## #  # ##    # #####     ###   #  #  #  # # ## # # #     #  #    ## #
#    ###      #    # ### # ##     #     ###  ### # # # #    # #####  #      # #  #  # # ##  # #  # #
## # #   ## #  # #     ## #   ## # # # #    # #  # ## # # ## #   ## # ## ##   ##  # ## #  # #  ##  #
# #  # # # #  # # ####     ## # #   #  ## # #  #    #   ##    # #  #  ### # #    #     ## #   #  # #
# ## # ###  #          # # #  # # #  #   #    #  # # ##   # # # # # #  #   # # #  # # # #  ##   #  #
#     #   # # ## ### #  ## ###   ## # # # ## # ##  #  # ## #  #     # # ##    # #    ##  #    #   ##
# # #   #     # #     ##      ##        # ##   #  #  #   #   ### ##       # #    # #    # # # #### #
##  #### # ## #   ## #   ## # # ## # ##     # #  ## # # # # ### #  #### #### ###    ####  ##       #
#  #         #  # #  # #  # #   # ###  # # #   # #           #    #       #  #   # #   ##  ## ## ###
## ### ## # ### #  #### ## #  #    # # # #  # #   # # # ### # ## ### ## ##  # ## #   ## # #    ##  #
# #   # # ## # # ##  #      #  # #     ##  #   # ## # # #         ###     #   # # # # #     # # # ##
# # # # ##     # #  #  # # # ## #  # #   #   #     # #  # # ## ##  # ## #   ##         # # ###     #
#  #       ## #   # ##  #         #  # #   # # ###     ##  #   # # # ### ##   ## ## ##    # ### ## #
## # ## # #    # ##   ## # ## ## #  #   # #   ## ## ###   ### #  #    #    # ##   ##  # # #  #   ###
#   #   ##  ##      # #      #    #  # ###  ##     #    #  ### #   ##   ##     # # # # ### # ## #  #
## # ### ## # ### #  #  # # ### ## ## # # ##  # # ## # ## # #    # #  # # # # #         #         ##
#          #  #  # #   #   # # # #  #        # #  # #  # #    ##  # ## #  # #  # #### #  # ## # # ##
# # ## # ## #   #    # # # # # # ## ## # # # #  # #  # # ## ##   #     ##  # #       # #     # # # #
##  # #       #  ## #   # #           # # ## # #  # ###    #  # # # # # # #    # # #    ## #       #
# # #  ## ## # #     # #  # # # ## ##     #  #   ##  # # ## # ##  ##        ## # #  ## # #  ## # # #
#  # #  # ####  # # # #  # # #  #   # # # ##   #   #            #    ### # ##   # #   #   #  #  ####
##   ## #  #   ###  #  #       ### # # #     ##  #   ### ##### ######    ##   #   # # # # # #  # # #
#  #     ## ##  # ##  # # # # # # #      # #  # #  ##    #      #     # #   #  ##  #     ##  # #   #
# #  # # #  #  #    # #  # # ##     # # ## # #  ##   # ##  ## #   # #  #  #  #  # # # # #  #  ## # #
# # #  #  #   # # #    #        ## # # #   #  ##   # #   ### # ## #  ##  #  ## #    # #   #  #   # #
# #  ##  #### #    ## # # # ## #  #  #   ## #  # # ## # #         # ## # ## #   ## #   # ###   #  ##
## ### # ##     ##  #    # #     # #   #    # # # #    # ## ## ## # #      #  # #  # ###  # # #  # #
#          # # ## ##  ##    # # #    # # # # #     # #       # #   #### # # #  # ###    #   # ##   #
### # # # #  # #    ##  # #   # # # #   # #    # #   # # ## ###  #  #    #    ##     # # # #   # # #
#  ### #   # # ## #   #  ### ##  #  # # #   ## #  # ###   #  ### # # ## ### # # ## # # #  # ##  ## #
## ##   # # #    # # # # ### #  # #  #   ##  #  # #  #  ##  # #  ##      # #    #  # #   #   # #  ##
##   # #     ## #         # #  #    #  # # #  #  #  #  # ##   # # ### # #   # ### #  # #   #  # #  #
#  #     # #  ## # ## ## ##  ## # #  # # #   ###  # # #    # # #      ##  #      #  #   ##  #     ##
##  # # #####     #    #   # #     # # # # ####  #   #  ##      # # #  ## # # # # # ## ### # # # # #
## #   # # # # ##   # #  #    # # #   #  ##  # ## # #  #   # # # # ## # ##   #    ##    #     #    #
# # ###        #### #  #  # #   #  # #  #  #         ##  ###  #       #    # ## #  ## ##  ###  # # #
# #     ## #### #    ##  ## ## # ##   # ##   # ## # # # #    # # ## #  # # #   # ##   ### # # ## # #
#  # # #  #       # #   #    #     # # #   # #  #  #    # # #    #  # #  # # #    # #  #    ##   # #
# # #  # # #### #  ### # ## #  ### # #   #  #  # #  # # # # ## # # #  # #  ### # # # #  # #   ## # #
#     #       #  #  # #      #   # # # # # ##### # # #  # #   #  # # #  ##    # #      #  # ###  # #
# # # # ## ##   ## #   ## # ## # #### # #  ##         # #  # # # #  ####   # #   # ## # # #    #  ##
####  ### #   # #   ##     #   #   ##     #   ## # # ###  #  #    # ##   #  ## # # #    # # # #  ###
# #  #      ### # # # # # # # #  #   # # # ## #  #  # # #  ##  ## ##  #### #    #   # ##  # #  #  ##
#   #  # # #     #  #    ##   # #  # ##  #     # ## #     ##  ##    #        # # # #    ##   #  #  #
## #  ####  # # #  #  # #   #  # # #   #  # ##  #   ## # #   #   # ## ## ## ##    #  ##   # #  # # #
#  ##  #   ###   #  # # ###  # #    # # ##  # #  ##  # ##  # # ## #  #    #   # #  # #  ##   #    ##
# #   # ##  # # # ## #     # ## # # # #    #    # # ###   ##  #   # #  # #  # #  ###  # ### # # #  #
# ## #     #       #   ## #   #  ## ##  ## ## ##     # ###   ####     #   # # # #    # # #     ## ##
##   # # # # # # # ## #    ### #     # #    #   # # #     # # # ## ## ## ###   ### # #     ## ##   #
## ## ## #  #   ###    # # #   # ## #  # ## # #### ## # #  #        #  #  #  # ###  # # # #     # ##
# # #    # #  #  ## # # #  # #   #   # ##  #  # #    #  ##   # ## ##  ## ### ## #  #  ##   ## #  # #
# # ## #  #  #  #   #   ### # ## # ####  # # #   # # # #   # #   #   #    #     ##   #   #   #  #  #
#      # # #  ## # ### #  #    # ##  # #    # # # #   #  # # ## # # ### #  # # #   # # ##  ##  #  ##
## # #  #  # #      #   # ## #  #  #    # #         #  ## # # ### #  #  # #  # ###  #   ##   #  #  #
#   #  # #    # # #  ##     # # ##  ## # # # # ## ## #              ###  # #  #    ## ##   ##  ## ##
# ## #    # # # # # # # # ##     # # #       #  #  #  # ## # ## # # ## ##  ## ## #   #   #   #     #
##     ## ## # #   #     #   # #       # # # # #  ## # #    #    ##    #  #    # # #  ##  # ## # # #
# # ##   #       ##  ## #  #  # # ## ##  #  #   ##       ### ## #   ##   #  # #   # #  # ##   # # ##
#   #  ##  # ###  # #   # #  ##    # #  # ##  # #  # # # #      ## #  # #  #   # ##   #  #  #      #
## #  #   # #    #   ##  #  ##  # #   # # # #  #  ###   #  ## #  # # #   #  # #    ##  ##  #  # ## #
#  ##  # ##   # ### ### #  #   #  # # # #     ###  #  ## #  ##  #     # ### # ## ##  # # # # ##  # #
##   ##    ## # ##   #  # #  # # #   # # # ##  #  #  #     #   #  # # #  #   #   #  #     #  #  #  #
# # # # ## #  #   # # # ## ##  # ####     #  ##### ### ###  ## ##  #  ##  # #  #   #  # #  #  # # ##
#  #    # #  ### ## # ## #    ###    # # # # # #       #   # #  # #  #   # # #  # ###  #  # # # #  #
# # # #    #  #  # #   #   ##  # ### ###         # ### # # #   #   ##  #   #  ##   ## # #    #  # ##
# #    ## ## #  #    ## # ### ##         # ### #  #     ##  # ### #### # #   ### #   #    ##  ##   #
#   # # # #  ##  # #       # #   # ## # ###     #  # ##   ##   #  #### ##  # ## #  #  # #   #   # ##
### # #   ##   ## #  # ## #    # # ###   # # # # #  #   # # # # #  ##    # #     #  ## #  # ## #   #
# # #  ##  ## #    ###  # # # # # # # ###  # # #   ####  #    #   #   # ##  # # # # #  # #   ##  # #
#   # #   #    ###     # # #  #          #    # # # #   #### #  #  ##  ##  ##  #  #   #  ## #   #  #
# #  #  # # # #    # # #     #  # ## # #   # ##   #   #  #   # #  #   #   #   # #   #  #   # # ### #
##  # ##  #  # # #  #   #### # #    #   # #  # # #  # # #  #  #  # ## ## ## # #   # ## # # #    #  #
# #   ## #  ##  #  # # ##   #   ## # # ##  #   #  #  #   ##  ### #     #   #   # ##  # #  #  # # # #
# # #   #  #   # #   ##   #   # #  #   #  #### # # # ## ### ###   # # #  #  # # #   #   # ## #   # #
#    ##  #  # ## # ## # ##  #  #  ## #  ## #    #  ## #  #   # ## # #  #  # ##    #  # #    #  # # #
# ##  # # ##  #    #      # # #  #  #  #     # # #  #   #  #    #  #  ## # #   # #  # # # # ## ## ##
#   ## ## # # # ##  # # ## #   ## #   #  ## #### # #  # # # # #  #  ##      ### # #     #  #       #
## ##  #         ##  #   # ## #     # # #   ##       #  #   #  # ## #  # # ##       # #  # ## ## # #
#    #   ## ### #   # # #      #### #  #  #   ## # #  # # # # # # # ## # # #  # # #  #  ##  # #   ##
## ## ##   #    # # #   # ### #     # # # ## # #  #  ###   #    # #  #  #   # #  #  ## #  #  ## #  #
#   #    #  # # #  #  # # #   # # # #    #      #  #  #  #  # #   # #  #  #  #  ### #    #  #   # ##
####################################################################################################
