##################################################
# # #   #    # #     #  #     #   ###     # # #  #
# # ## # # #     ## #  #  # ##  #  # ####   #  # #
# #       # # ## # ###  #  #   # #   #   # #  #  #
#  ### # #      #   #  #  ### #    ## ##     # # #
# #     # ## # # ##  #  #  ### ## ##  #  # ### # #
# # ## #    #     # #  # #  #  #  #  #  ## #     #
#  #    # #  # ###   #   # # # # ###   #  ### ####
# # ## #   # #   # ##  # #   # #  #  #   # #     #
#    #  # #  # ##     # #  #    #  ##  ##    # # #
####   ### #     ## ##   #  # #   # ##    # # # ##
#    # ##  # # ##   # # # ## # # #    # #  #  #  #
### ##   # ##  # ## # # #         # # #  #   #  ##
#  ##  #     #   #       ## ## ##    #  # # ## ###
# #  #### ##   ## # ## ##  #  ##  # #  #   #   ###
#  # # # #  # ##      ####   #  ##  # #  ## # # ##
# #  #    #   # # # ## #### ###   #    #         #
# ## # # # ## # #  #    ##   ### # # ##  ## # # ##
#  #  #       #   # # #   # # #         #### # # #
## ##   ## ##   #    # ## #   # ## # ### ##      #
#     ##  #  # # ## #   #   # # #  #        # # ##
# # ##   # #   #  ## ##   ##### ###  # # # # #   #
##    ## #   #  #    # ## # #  #  ##  # ###  ### #
#  # #    # #  #  # ##    #   ###  # #   #  #   ##
### # ## # # #  ##     # ## ## # # #   #   #  ## #
#              #  # ######   # #     ## # ###  # #
## # # ## ## #  # #    #  # #  # ## # #  # ###   #
####  #  #  #  ## # # # # #  #  #   #  #    #  # #
##  ## # # # #       ## # # # #  ## ##   ## # ## #
#  ##          # # #            # #    #  #     ##
# ## # ## ## # #  #  #### # # #     ##  #  # # # #
#       ##    # ## #     #  # # ## #  # # #   #  #
# ### #  # # #       ## # #  ## #    ###  # #   ##
# #    ##   ### ## #   #  ##   # ## # # ##   ##  #
##  # #  ### # # ##  ##  #   #   ##       # #   ##
#  #   #     # #   #    # # #  ##   # # #  # # # #
##  # #  # # # # ##  ## # ## #   ##  # #  #  #   #
#  #   ##### # # # #  #      # #   #    #   # ####
##  # #  #           # ### #  # # #  # # ###     #
#  # # #   # # ## ##      #  #    ####       ### #
# #      #  #   # ### # # # # # #     ## # #    ##
# ## ## # # # ##   #  # # #    #  # #   #  # ##  #
## # ###   #   # #  ##   ### ## ## ## ## # #   # #
#     #  #  # #   ##   #  #        #     #  # #  #
# ## #  # #   ## # # # # # ## # # # ## # # ##### #
## # ###  # #  #   #  #      ## #   ##  #   # # ##
##     ##   # ### # ## # ## #    ##   # # #      #
# # # # ## #   #    ##    # ## #   ##  #  # # # ##
#    #      # ### #   # # #  #  # ####  # # #  ###
##################################################
